Theodora	Wunsch	Jonas@orville.biz
Claudia	Carter	Maximo@monserrate.biz
Terrence	Cruickshank	Cortney@murray.tv
Leilani	Carroll	Bernardo@louvenia.biz
Thea	Balistreri	Madisen@fannie.ca
Maximus	Hansen	Kendrick.Abbott@guadalupe.ca
Aglae	Heathcote	Randal_Schimmel@luigi.org
Crystal	Balistreri	Lysanne.Rutherford@carey.io
Bert	Blick	Ruthie_Bernhard@noble.org
Abraham	Kuphal	Salvador@madisyn.com
Joannie	Schowalter	Creola.Spinka@cristian.biz
Dorthy	Nitzsche	Valentina@vincenzo.org
Lucious	Williamson	Fatima.Schimmel@justyn.tv
Rey	Bahringer	Laisha_Hamill@jimmy.net
Ivory	Lind	Ismael.Considine@darby.co.uk
Adrien	Paucek	Elena.Blanda@devon.us
Cassandra	Mraz	Stefan@donny.biz
Immanuel	Tromp	Robb_Weber@chaz.name
Piper	Swift	Demarcus.Hilll@keagan.me
Foster	Marks	Jayson.Bartoletti@jaycee.ca
